####################
#------------------#
#------------------#
#------------------#
#------------------#
#------------------#
#------------------#
#------~~~~~~------#
#------~----~------#
#-----------------~#
#-----------------~#
#---------~-------~#
#---------~~~~~~~~~#
####################